1111111111111111
1E00000000000001
1C10010100100001
1010010010101011
1P0000000000C001
100000011C000C01
1111111111111111
