1111111111
1EC0000001
1C0C010101
1P10010011
1000000001
1111111111
